"filename", "language", "Java", "Markdown", "comment", "blank", "total"
"c:\Users\siddi\OneDrive\Documents\GitHub\Casinopoly\README.md", "Markdown", 0, 2, 0, 0, 2
"c:\Users\siddi\OneDrive\Documents\GitHub\Casinopoly\game\game\Roulette.java", "Java", 398, 0, 26, 64, 488
"c:\Users\siddi\OneDrive\Documents\GitHub\Casinopoly\game\game\allorNothing.java", "Java", 76, 0, 13, 21, 110
"c:\Users\siddi\OneDrive\Documents\GitHub\Casinopoly\game\game\blackJack.java", "Java", 160, 0, 14, 46, 220
"c:\Users\siddi\OneDrive\Documents\GitHub\Casinopoly\game\game\cardGame.java", "Java", 198, 0, 43, 72, 313
"c:\Users\siddi\OneDrive\Documents\GitHub\Casinopoly\game\game\casinopolyShop.java", "Java", 515, 0, 46, 49, 610
"c:\Users\siddi\OneDrive\Documents\GitHub\Casinopoly\game\game\casinopolyShop2.java", "Java", 460, 0, 44, 48, 552
"c:\Users\siddi\OneDrive\Documents\GitHub\Casinopoly\game\game\chanceWheel.java", "Java", 72, 0, 26, 31, 129
"c:\Users\siddi\OneDrive\Documents\GitHub\Casinopoly\game\game\gameBoard.java", "Java", 87, 0, 26, 42, 155
"c:\Users\siddi\OneDrive\Documents\GitHub\Casinopoly\game\game\giantWheel.java", "Java", 72, 0, 7, 16, 95
"c:\Users\siddi\OneDrive\Documents\GitHub\Casinopoly\game\game\giantWheel2.java", "Java", 71, 0, 7, 16, 94
"c:\Users\siddi\OneDrive\Documents\GitHub\Casinopoly\game\game\jackpotWheel.java", "Java", 57, 0, 7, 15, 79
"c:\Users\siddi\OneDrive\Documents\GitHub\Casinopoly\game\game\jail.java", "Java", 86, 0, 29, 34, 149
"c:\Users\siddi\OneDrive\Documents\GitHub\Casinopoly\game\game\penaltyWheel.java", "Java", 52, 0, 22, 21, 95
"c:\Users\siddi\OneDrive\Documents\GitHub\Casinopoly\game\game\slots.java", "Java", 105, 0, 33, 41, 179
"c:\Users\siddi\OneDrive\Documents\GitHub\Casinopoly\game\game\startAndGo.java", "Java", 15, 0, 8, 11, 34
"c:\Users\siddi\OneDrive\Documents\GitHub\Casinopoly\game\game\wheelMethods.java", "Java", 370, 0, 94, 87, 551
"c:\Users\siddi\OneDrive\Documents\GitHub\Casinopoly\src\ai.java", "Java", 7, 0, 5, 2, 14
"c:\Users\siddi\OneDrive\Documents\GitHub\Casinopoly\src\casinopolyMain.java", "Java", 40, 0, 17, 20, 77
"c:\Users\siddi\OneDrive\Documents\GitHub\Casinopoly\src\inventory1.java", "Java", 37, 0, 4, 28, 69
"c:\Users\siddi\OneDrive\Documents\GitHub\Casinopoly\src\inventory2.java", "Java", 11, 0, 0, 11, 22
"c:\Users\siddi\OneDrive\Documents\GitHub\Casinopoly\src\player.java", "Java", 18, 0, 8, 14, 40
"c:\Users\siddi\OneDrive\Documents\GitHub\Casinopoly\src\player2.java", "Java", 10, 0, 7, 12, 29
"c:\Users\siddi\OneDrive\Documents\GitHub\Casinopoly\src\turns.java", "Java", 372, 0, 8, 43, 423
"Total", "-", 3289, 2, 494, 744, 4529